1111111111111111111111111111
1000000000000000000000000001
1001110000100011100011100001
1001000011100010000011100001
1000000000000011100011100001
1000000000000000000000000001
1001111111000011100011100001
1000000000000011100000100001
1001011111000011100011100001
1001010001000000000000000001
1001010101000010000000100001
1001010101000001000001000001
1001010101000000100010000001
1000000000000000010100000001
1001111111000000001000000001
1000001000000000010100000001
1000001000000000100010000001
1000001000000001000001000001
1000001000000010000000100001
1000000000000000000000000001
1000111111111111111111100001
1000000100000100000100000001
1000100100000100000100100001
1000100000100000100000100001
1000100000100000100000100001
1000111111111111111111100001
1000000000000000000000000001
1111111111111111111111111111