11111111111111111111111111111
10000000000000000000000000001
10100010001000110010001000101
10001000100010110000100010001
10100010001000110010001000101
10001000100010110000100010001
10100010001000110010001000101
10001000100010110000100010001
10100010001000110010001000101
10001000100010110000100010001
10100010001000000010001000101
10001000100000000000100010001
10000000000001111000000000001
10111111111001111001111111101
10111111111001111001111111101
10000000000001111000000000001
10100010001000000010001000001
10001000100010000000100010001
10100010001000110010001000101
10001000100010110000100010001
10100010001000110010001000101
10001000100010110000100010001
10100010001000110010001000101
10001000100010110000100010001
10100010001000110010001000101
10001000100010110000100010001
10000000000000000000000000001
11111111111111111111111111111
