1111111111111
1000000000001
1000000000001
1000001000001
1000001000001
1000001000001
1110001000111
1000001000001
1000001000001
1000001000001
1000000000001
1000000000001
1111111111111
